1111111111111111111111
1111111111111111111111
11P01E0000000000000011
1100101111111111110011
11001C01000001C0010011
11001B01B0100110110011
11001001001C0100010011
11001B01C0100100010011
110010010C1B0100010011
11001B01C010010B000011
11001001B01C0100010011
11001B010C100100010011
11001001C01B0100010011
11001B010C100100010011
11001000C0100000010011
1100111111111111110011
1100000000000000000011
1111111111111111111111
1111111111111111111111