11111111111111111111
1P01E000000000000001
10011111111111111001
1001C01000001C001001
1001B01B010011011001
1001001001C010001001
1001B01C010010001001
10010010C1B010001001
1001B01C010010B00001
1001001B01C010001001
1001B010C10010001001
1001001C01B010001001
1001B010C10010001001
1001000C010000001001
10011111111111111001
10000000000000000001
11111111111111111111